#######################
#..........#..........#
#*###.####.#.####.###*#
#...#.#....#....#.#...#
#.#.#.#.#######.#.#.#.#
#.#.#.#....#....#.#.#.#
#.#.#.####.#.####.#.#.#
#.#...#.........#...#.#
#.###.#.###%###.#.###.#
#.......#  $  #.......#
###.###.#######.###.###
#...###....@....###...#
#.#####.#.###.#.#####.#
#.......#..#..#.......#
#.###.####.#.####.###.#
#*..#.#.........#.#..*#
###.#.#####.#####.#.###
#...#.....#.#.....#...#
#.###.###.#.#.###.###.#
#.....................#
#######################
