#######################
#..........*..........#
#.###.####.#.####.###.#
#..........@..........#
#.###.#####.#####.###.#
#.....................#
#.###.###########.###.#
#.....#.........#.....#
#####.#.#######.#.###.#
#*......#  $  #......*#
#.###.#.###%###.#.#####
#.....#.........#.....#
#.#####.#######.#####.#
#..........#..........#
#.###.####.#.####.###.#
#...#.............#...#
#.#.###.#######.###.#.#
#..........#..........#
#.########.#.########.#
#..........*..........#
#######################
