#######################
#..........#..........#
#*###.####.#.####.###*#
#.....................#
#.###.#.#######.#.###.#
#.....#....#....#.....#
#####.####.#.####.#####
#   #.#.........#.#   #
#####.#.###%###.#.#####
#.......###$###.......#
#####.#.#######.#.#####
#   #.#....@....#.#   #
#####.#.#######.#.#####
#..........#..........#
#.###.####.#.####.###.#
#*..#.............#..*#
###.#.#.#######.#.#.###
#.....#....#....#.....#
#.########.#.########.#
#.....................#
#######################
