#######################
#@....................#
#.########.#.########.#
#....*.....#.....*....#
#.#.####.#####.#.##.#.#
#.#....#.......#.##.#.#
#.#.##.#######.#.##.#.#
#.#.##.#.......#.##.#.#
#.#.##.#.#######.##.#.#
#.#.##.#.......#.##.#.#
#.#......#####......#.#
#.#.##.#.......#.##.#.#
#.#.##.#######.#.##.#.#
#.#.##.#.......#.##.#.#
#.#.##.#.#######.##.#.#
#.#.##.#.......#....#.#
#.#.##.#.#####.####.#.#
#....*.....#.....*....#
#.########.#.########.#
#....................$#
#######################
